## Medications & Pharmacology (Rx) (22)
- APAP: Acetaminophen (APAP)
- ASA: Acetyl salicylic acid (Aspirin)
- Consultation: Cardiogenic Shock or Post-ROSC Stabilization: = 1mcg/kg IVP/IO    From Push-Dose Epi
- D10W: Dextrose 10% in water
- D25W: Dextrose 25% in water
- D50: 50% Dextrose
- D5W: Dextrose 5% in water
- Epi: Epinephrine
- HCTZ: Hydrochlorothiazide
- HRT: Hormone replacement therapy
- IDDM/DM I: Insulin dependent diabetes mellitus (Type I)
- LR: Lactated Ringers
- MDI: Metered dose inhaler
- MS: Morphine Sulfate, Multiple Sclerosis
- NIDDM/DM II: Non-insulin dependent diabetes mellitus (Type II)
- NKDA: No known drug allergies
- NS: Normal saline
- NSAID: Non-steroidal anti-inflammatory drug
- NTG: Nitroglycerin
- OD: Overdose, right eye (oculus dexter)
- Rx: Prescription
- SL: Sublingual, Saline Lock

## Measurements & Units (37)
- 1: First degree or Primary
- 2: Second degree or Secondary
- 3: Third degree or Tertiary
- AIVR: Accelerated Idioventricular rhythm
- AVA: Alternate vascular access
- CCB: Calcium channel blocker
- CCR: Cardiocerebral Resuscitation
- CCU: Coronary / critical care unit
- CVA: Cerebrovascular accident
- Cc: Cubic centimeter
- Cm: Centimeter
- Co: Centigrade
- DCAPBTLS: Deformities, Contusions, Abrasions, Penetrations,Paradoxical movements, Burns, Tenderness, Lacerations,
- ECG/EKG: Electrocardiogram
- EEG: Electroencephalogram
- Fo: Fahrenheit
- Gm, g: Gram
- Gtts: Drops
- ICU: Intensive care unit
- IU: International units
- Kg: Kilogram
- L: Left or Liter
- Lac: Laceration
- Lpm: Liter per minute
- MAP: Mean arterial pressure
- Mcg: Microgram
- Mph: Miles per hour
- NICU: Neurological, neonatal intensive care unit
- PICU: Pediatric intensive care unit
- PTS: Pediatric trauma score
- RTS: Revised trauma score
- SA02: Oxygen saturation of arterial oxyhemoglobin
- U: Unit
- dL: Deciliter (1/10 liter: 100 ml)
- mL: Milliliter
- mg: Milligram
- mm: Millimeter

## Anatomy & Patient Conditions (50)
- AAA: Abdominal aortic aneurysm
- ACS: Acute Coronary Syndrome
- AIDS: Acquired immunodeficiency syndrome
- ARDS: Adult respiratory distress syndrome
- Abd: Abdomen
- Ant: Anterior
- BBS: Bilateral breath sounds
- C-spine: Cervical spine
- CA: Carcinoma, cancer
- CABG: Coronary artery bypass graft
- CAD: Coronary artery disease
- CHI: Closed head injury
- CID: Cervical Immobilization Device
- COPD: Chronic obstructive pulmonary disease
- DIC: Disseminating intravascular coagulation
- DVT: Deep vein thrombosis
- Dx: Diagnosis
- ESRD: End stage renal disease
- EXT: Extremity(s)
- ExDS: Excited Delirium Syndrome
- Fx: Fracture
- GERD: Gastroesophageal reflux disease
- ICP: Intracranial pressure
- KVO: Keep vein open
- L spine: Lumbar spine
- L&D: Labor and delivery
- L/S: Lung sounds
- LAD: Left axis deviation / left anterior descending
- LMP: Last menstrual period
- LSB: Long spine board
- MOI: Mechanism of injury
- NOI: No obvious injury
- OBS: Organic brain syndrome
- PA: Physician assistant, pulmonary artery
- PE: Physical exam, pulmonary emboli, pulmonary edema
- PID: Pelvic inflammatory disease
- PSO: Paramedic Standing Orders / Patient Safety Organization
- RAD: Right axis deviation, reactive airway disease
- RCA: Right coronary artery
- RHD: Rheumatic heart disease
- SARS: Severe acute respiratory syndrome
- SCI: Spinal cord injury
- SCUBA: Self-contained underwater breathing apparatus
- SIDS: Sudden infant death syndrome
- STD: Sexually transmitted disease
- T spine: Thoracic spine
- TBI: Traumatic brain injury
- URI: Upper respiratory infection
- UTI: Urinary tract infection
- post.: Posterior

## Cardiovascular & Hemodynamics (34)
- 2.: Hypotension (SBP <100 mmHg) probabky relative??
- A Fib: Atrial fibrillation
- ABG: Arterial blood gas
- AICD: Automatic Implanted Cardioverter Defibrillator
- AMI: Acute myocardial infarction
- AV: Atrioventricular
- Af: Atrial flutter
- BBBB: Bundle branch block
- BP: Blood Pressure
- CHF: Congestive heart failure
- CK-MB: Creatine kinase myocardial band
- CO: Cardiac output / carbon monoxide
- CPR: Cardiopulmonary resuscitation
- CVP: Central venous pressure
- FHx: Family history
- HR: Heart rate
- IVP: IV push IVR Idioventricular rhythm
- JVD: Jugular venous distention
- LBBB: Left bundle branch block
- LSD: Lysergic acid diethylamide
- LVAD: Left Ventricular Assist Device
- LVH: Left ventricular hypertrophy
- PCI: Percutaneous coronary intervention
- PEA: Pulseless electrical activity
- PSVT: Paroxysmal supraventricular tachycardia
- PVC: Premature ventricular contraction
- PVT: Polymorphic ventricular tachycardia
- RBBB: Right bundle branch block
- SBP: Systolic blood pressure
- SVT: Supraventricular tachycardia
- VF: Ventricular fibrillation
- VT: Ventricular tachycardia
- o: Symptomatic BRADYCARDIA
- o: Cardiogenic Shock

## Respiratory & Airway (27)
- 02: Oxygen
- 2.: 50yo (asthma) usually for the 1:1,000 for bronchospam
- ABC: Airway, breathing, circulation
- BS: Breath, bowel sounds
- BVM: Bag valve mask
- BiPAP: Bi-level Positive Airway Pressure
- CAO x 3 or 4: Conscious, Alert, & Oriented to Person, Place, Time & Events
- CPAP: Continuous positive airway pressure
- DOE: Dyspnea on exertion
- ET: Endotracheal
- ETT: Endotracheal tube
- FBAO: Foreign body airway obstruction
- IMV: Intermittent mechanical ventilation
- IPPB: Intermittent positive pressure breathing
- LMA: Laryngeal Mask Airway
- NPA: Nasopharyngeal airway
- NRB: Non-rebreather mask
- NT: Nasotracheal
- OPA: Oropharyngeal airway
- P02: Partial pressure of oxygen
- PAI: Pharmacologically assisted intubation, Pre-Arrival Instructions
- PND: Paroxysmal nocturnal dyspnea
- PPV: Positive Pressure Ventilation
- RR: Respiratory rate
- RRT: Registered Respiratory Therapist
- RSV: Respiratory syncytial virus
- SOB: Shortness of breath

## Neurologic & Trauma (11)
- CNS: Central nervous system
- CNS: Central nervous system
- CP: Chest pain
- CSF: Cerebrospinal fluid
- DTs: Delirium tremens
- FSP: Full spinal precaution
- GCS: Glasgow coma scale/score
- NMB: Neuromuscular blockade
- PERRL: Pupils equal round reactive to light
- Pn: Pain
- TIA: Transient ischemic attack

## Diagnostics, Labs & Imaging (31)
- +CMS: Positive circulatory, motor & sensory function
- ADD: Attention deficit disorder
- AED: Automated external defibrillator
- APGAR: Appearance, Pulse, Grimace, Activity, Respiratory effort
- APS: Adult Protective Services
- AS: Left ear (auris sinistra)
- C/C: Chief complaint
- CAT/CT: Computerized axial tomography scanner
- CBC: Complete blood count
- CMO: Chief Medical Officer
- CPS: Child Protective Services
- CRT: Capillary refill time
- CTA: Clear to auscultation
- CXR: Chest x-ray
- DO: Doctor of Osteopathy
- EF: Ejection fraction
- EPS: Electrophysiological study
- FHR: Fetal heart rate
- GI: Gastrointestinal
- HIV: Human immunodeficiency virus
- KTD: Kendrick traction device
- LLQ: Lower left quadrant
- LUQ: Left upper quadrant
- NP: Nurse Practitioner
- OMD: Office of the Medical Director
- OS: Left eye (oculus sinister)
- PMD: Primary/Private medical doctor
- SOAPE: Subjective, Objective, Assessment, Plan, Enroute
- TASER: Thomas A. Swift Electric Rifle
- U/A: Upon arrival, urine analysis
- p.r.: Per rectum

## Procedures & Equipment (41)
- +: Positive
- +ROM: Positive range of motion
- 1.: Known hypersensitivity
- ?: Questionable, possible
- A.E.: Above elbow (amputation)
- A.K.: Above knee (amputation)
- AB: Abortion
- ACE: Angiotensin-converting enzyme
- AOS TF: Arrived On Scene To Find
- ATF: Arrived to find
- AVM: Arteriovenous malformation
- B.E.: Below elbow (amputation)
- B.K.: Below knee (amputation)
- CO2: Carbon dioxide
- D&C: Dilatation & curettage
- DNAR: Did not attempt resuscitation
- EGA: Estimated Gestational Age
- ETA: Estimated time of arrival
- ETC02: End-tidal carbon dioxide
- EXP: Expansion
- HTN: Hypertension
- IO: Intraosseous
- IV: Intravenous
- Inf: Inferior
- KED: Kendrick extrication device
- LOC: Level/loss of consciousness
- MCL: Midclavicular line, modified chest lead
- NGT: Nasogastric tube
- NH: Nursing home
- OBV: Obvious
- OLMC: On-line medical consultation/control
- PEEP: Positive end expiratory pressure
- POC: Position of comfort
- POV: Privately operated/owned vehicle
- PTA/PTOA: Prior to (our) arrival
- ROSC: Return of spontaneous circulation
- TB: Tuberculosis
- TCP: Transcutaneous pacing
- mEq: Milliequivalent
- o: Post-ROSC Stabilization
- pC02: Carbon dioxide pressure

## Operations & Agencies (15)
- ALS: Advanced Life Support
- BLS: Basic life support
- DOS: Dead on scene
- EMS: Emergency Medical Services
- EOR: End of Report
- ER/ED: Emergency room/department
- ILS: Intermediate life support
- LSV: Life Support Vehicle (ambulance)
- MD: Medical Doctor
- OB: Obstetrics
- X-prt: Transport
- hs: hora somni; hour of sleep; at bedtime
- q.i.d.: Four times a day
- t.i.d.: Three times a day
- x: Times

## Assessment & Clinical Documentation (110)
- #: Number
- <: less than
- =: Equal
- >: greater than
- @: At
- A&Ox3: Alert & oriented to name, date, and place
- A/C: Aircraft
- BGL: Blood glucose level
- BM: Bowel movement
- BSA: Body surface area
- CI: Chlorine
- CK: Creatine kinase
- CSM: Carotid sinus massage
- Ca++: Calcium
- Cx: Chest
- DAE: Dysbaric air embolism
- DKA: Diabetic ketoacidosis
- DM: Diabetes mellitus
- DNR: Do-not-resuscitate
- DOB: Date of birth
- DPT: Diphtheria, pertussis, tetanus
- Diff: Difficulty
- Disch: Discharge
- EDC: Estimated date of confinement
- ETOH: Ethyl alcohol, alcoholic beverage
- Est.: Estimated
- FUO: Fever of unknown origin
- Fr: French
- GU: Genitourinary
- GYN: Gynecology
- H&H: Hemoglobin and hematocrit
- H/A: Headache
- HAV: Hepatitis A virus
- HBV: Hepatitis B virus
- HCV: Hepatitis C virus
- HEENT: Head, eyes, ears, nose, throat
- Hg: Mercury
- Hr: Hour
- Hx: History
- IM: Intramuscular
- J: Joules
- K+: Potassium
- Lbs: Pounds
- Liq: Liquid
- MAE: Moves all extremities
- MMR: Measles, mumps, rubella
- MVC: Motor vehicle crash
- MVP: Mitral valve prolapse
- N/C: Nasal canula
- N/V/D: Nausea, vomiting, diarrhea
- NAD: No apparent / acute distress
- NES: Non-English Speaking
- NKA: No known allergies
- NPO: Nothing by mouth
- Na+: Sodium
- OOH: Out of hospital
- OPP: Organophosphate poisoning
- OR: Operating room
- P (+ #): Parity (P3, P4 etc)
- P/CD: Pink warm and dry
- PCP: Phencyclidine, Primary Care Physician
- PO: By mouth
- PRBCs: Packed red blood cells
- PRN: As needed
- Pt.: Patient
- Q: Q
- Qh: Q hour
- R: Right
- RLQ: Right lower quadrant
- RN: Registered nurse
- RUQ: Right upper quadrant
- Rbc: Red blood cell, red blood (cell) count
- SC, SQ: Subcutaneous
- SROM: Spontaneous Rupture of Membranes
- SUV: Sport utility vehicle
- Sx: Symptoms
- TCA: Tricyclic antidepressant
- TKO: To keep open
- Tbsp: Tablespoon
- Temp: Temperature
- Tsp: Teaspoon
- Tx: Treatment
- UTL: Unable to locate
- UTO: Unable to obtain
- VO: Verbal order
- VS: Vital signs
- Vol: Volume
- Vt: Tidal volume
- WDWN: Well developed, well nourished
- WPW: Wolf-Parkinson-White
- Xfer: Transfer
- a: a
- a.c.: A meals
- a.d.: Right ear (auris dexter)
- b.i.d.: Twice a day
- c: c
- c: c
- c/o: Complains / complaining of
- co: Cout, wide open
- e.g.: For example
- mA: Milliamperes
- o: VF or pVT:
- oz.: Ounce
- p: p
- q: each
- s: Cout
- s: cout
- s/s: Signs / symptoms
- tab: Tablet
- y/o: Years old

