- AIR AMBULANCE UTILIZATION — Administrative & Legal Essentials > AIR AMBULANCE UTILIZATION
- Allergic Reaction — Adult Protocols > Medical Emergencies > Allergic Reaction
- ALS Ground Rules — Administrative & Legal Essentials > ALS Ground Rules
- Anaphylaxis — Adult Protocols > Medical Emergencies > Anaphylaxis
- Bradycardia — Adult Protocols > Circulation/Cardiology > Bradycardia
- Cardiogenic Shock (not post arrest) — Adult Protocols > Circulation/Cardiology > Cardiogenic Shock (not post arrest)
- Clinical Errors & Reporting — Administrative & Legal Essentials > Clinical Errors & Reporting
- COMA/OD — Adult Protocols > Airway & Breathing > COMA/OD
- Consulting OLMC — Administrative & Legal Essentials > Consulting OLMC
- Core Principles â€“ Safety & Well-Being — Introduction & Core Principles > Core Principles â€“ Safety & Well-Being
- CPAP or BiPAP — Adult Protocols > Airway & Breathing > CPAP or BiPAP
- Cricothyrotomy — Adult Protocols > Airway & Breathing > Cricothyrotomy
- Crime Scene — Administrative & Legal Essentials > Crime Scene
- Diltiazem Add-Vantage Directions — Skills & Equipment > Diltiazem Add-Vantage Directions
- Dispatching MD [200] — Administrative & Legal Essentials > Dispatching MD [200]
- EMR Accompanying Critically Ill — Administrative & Legal Essentials > EMR Accompanying Critically Ill
- ET Intubation — Adult Protocols > Airway & Breathing > ET Intubation
- EZ-IO Insertion — Skills & Equipment > EZ-IO Insertion
- Fall or Weakness — Adult Protocols > Medical Emergencies > Fall or Weakness
- Glucometer (McKesson True Metrix Pro) — Skills & Equipment > Glucometer (McKesson True Metrix Pro)
- Hyperglycemia — Adult Protocols > Medical Emergencies > Hyperglycemia
- Hyperkalemia — Adult Protocols > Circulation/Cardiology > Hyperkalemia
- I-gel Supraglottic Airway (SGA) — Skills & Equipment > I-gel Supraglottic Airway (SGA)
- Introduction to Abbott — Introduction & Core Principles > Introduction to Abbott
- LVAD pt — Adult Protocols > Circulation/Cardiology > LVAD pt
- Major Level 1 Trauma — Adult Protocols > Trauma > Major Level 1 Trauma
- Mandatory Reporting — Administrative & Legal Essentials > Mandatory Reporting
- Medication Administration Cross Check (MACC) — Administrative & Legal Essentials > Medication Administration Cross Check (MACC)
- Minutes of Oxygen by Cylinder Size — Skills & Equipment > Minutes of Oxygen by Cylinder Size
- Mucosal Atomization Device (M.A.D.) — Skills & Equipment > Mucosal Atomization Device (M.A.D.)
- N/V — Adult Protocols > Medical Emergencies > N/V
- Nasal Intubation — Adult Protocols > Airway & Breathing > Nasal Intubation
- On-Scene Authority — Administrative & Legal Essentials > On-Scene Authority
- On-Scene Healthcare Professionals — Administrative & Legal Essentials > On-Scene Healthcare Professionals
- Pain — Adult Protocols > Medical Emergencies > Pain
- PCR Requirements — Operational Protocols > PCR Requirements
- PEA/Asystole — Adult Protocols > Circulation/Cardiology > PEA/Asystole
- Pediatric Assessment & VS — Pediatric Protocols > Pediatric Assessment & VS
- Pulmonary Edema — Adult Protocols > Circulation/Cardiology > Pulmonary Edema
- PUSH-DOSE EPI — Skills & Equipment > PUSH-DOSE EPI
- Refusals — Adult Protocols > Refusals
- Refusals — Pediatric Protocols > Refusals
- Rehabilitation: Emergency Incidents & Municipal Partners — Administrative & Legal Essentials > Rehabilitation: Emergency Incidents & Municipal Partners
- Respiratory & Airway — Abbreviations & References > Abbott Approved Abbreviations > Respiratory & Airway
- Response Mode — Administrative & Legal Essentials > Response Mode
- Restraint of Agitated/Combative Patients — Operational Protocols > Restraint of Agitated/Combative Patients
- Richmond Agitation Sedation Scale (RASS) — Operational Protocols > Richmond Agitation Sedation Scale (RASS)
- ROSC Stabilization — Adult Protocols > Circulation/Cardiology > ROSC Stabilization
- SAI — Adult Protocols > Airway & Breathing > SAI
- Scope Violations & Possible Consequences — Administrative & Legal Essentials > Scope Violations & Possible Consequences
- Seizure — Adult Protocols > Medical Emergencies > Seizure
- Sepsis — Adult Protocols > Medical Emergencies > Sepsis
- SGA -> Cardiac Arrest = Use 1st — Adult Protocols > Airway & Breathing > SGA -> Cardiac Arrest = Use 1st
- Sickle Cell Crisis — Adult Protocols > Medical Emergencies > Sickle Cell Crisis
- SLUDGEM pt — Adult Protocols > Medical Emergencies > SLUDGEM pt
- Special Needs Children — Pediatric Protocols > Special Needs Children
- Suspension/Revocation — Administrative & Legal Essentials > Suspension/Revocation
- Tension Pneumo — Adult Protocols > Airway & Breathing > Tension Pneumo
- Thermometer (Braun ThermoScan) — Skills & Equipment > Thermometer (Braun ThermoScan)
- TRACHEOSTOMY CARE — Adult Protocols > Airway & Breathing > TRACHEOSTOMY CARE
- Transfer to Lesser Credential — Administrative & Legal Essentials > Transfer to Lesser Credential
- Trauma — Pediatric Protocols > Trauma
- Understanding Ratios, Percentages & Solution Mixtures — Skills & Equipment > Understanding Ratios, Percentages & Solution Mixtures
- VENTILATOR Pt; Intubated & Sedated — Adult Protocols > Airway & Breathing > VENTILATOR Pt; Intubated & Sedated
- Ventilator Set-Up (ParaPAC Plus) — Skills & Equipment > Ventilator Set-Up (ParaPAC Plus)
- Workerâ€™s Compensation Process — Administrative & Legal Essentials > Workerâ€™s Compensation Process
